                           3333333333333333333333333333333333333
  3333       333333333     3                               CCCC3
  3  333333333  b    3333333 33333333 333333333333333333333CCK 3
  3    b              CCCC   Q3     3 3                   333333
  3                 333333    3     3 3         AA             3
  3 000 000        3     3    3     3 3         AA             3
  3   0 0    333   3     3 m Q3  x  3 3         /\             3
  3   0 0   3  3   3  x   33333     3 3   c    /42\            3
  3   0 0 3        3         33       3       /4##2\          J3
  3   0 0 3     3333                  3      /4#~-#2\          3
  3     0 3  x        333333     333333     /4#~  -#2\         3
  3       3       33333    3     3         /4#~    -#2\   c    3
  3    3  3     333        3  x  3        /4#~      -#2\       3
  3CC  3  333333           3     3       /4#~        -#2\      3
  3  C 3             00000 3     3CCCCC /4#~          -#2\     3
  3   C3             0AAA0 3333333   CC/4#~            -#2\    3
  3 o  3   3333333   0 m 0            /4#~9*9*      9*  -#2\   3
  3    33333     3CCCCCCCCCCC        /4#~9####* 9* 9##*  -#2\  3
  3              3A3333333333     o  (______________________)  3
  3              3 3        3                                  3
  3333333333333  3 3        3                                  3
   3          3  3m3 33333  3                                  3
   3   C      3  333     3  3   333333333333                   3
   3  CC      3    3     3  3   3     MMM  333333333333333333333
   3 CCC      3          3  3   3          AA MMMMM       Q3    
   3    3     333333333333  3   3                         Q3    
   3    3  o                3   3                         Q3    
   3P   3                   3   3   c                     Q3    
   3P   3                  J3   3           c       c     Q3    
   3P   333333333333333333333C  3                         Q3    
   3P           b            CC 3     c                   Q3    
   3P                      CC C 3              AA         Q3    
   3                       CCCC 3                         Q3    
   3          m       B     C   3      WWWWWW     WWWW mD Q3    
   33333333333333333333333333   3   333333333333333333333333    
                           /333 3 33\                           
                          /7)CCCCCC(8\                          
                         /7)   /1\  (8\                         
                        /7)    ^#@ c (8\                        
                       /7)     ^#@    (8\                       
                      /7)      ^#@     (8\                      
                     /7)   C   ^#@      (8\                     
                    /7)  CCCC  ^#@  x    (8\                    
                   /7)   c     ^#@      00(8\                   
                  /7)00        ^#@     00  (8\                  
                 /7)        0  ^#@          (8\                 
                /7)            ^#@           (8\                
               /7)      o      ^#@   x    c   (8\               
              /7)  0           ^#@             (8\              
             /7)               ^#@              (8\             
            /7)    c 0     0000^#@      0        (8\            
           /7)          o      ^#@0000       x    (8\           
          /7)    o             ^#@                 (8\          
         /7)                o  ^#@        c        0(8\         
        /7)000      00         ^#@              0000 (8\        
       /7)   0       0000   c  ^#@    x        0      (8\       
      /7)                      ^#@                     (8\      
     /7)         0          0  ^#@                      (8\     
    /7)    o                   ^#@        0              (8\    
   /7)                         ^#@   CCC       x   0      (8\   
  /7)          c      o        (#@  CCCC                   (8\  
 /7)                            ()         0                (8\ 
/7)                       c     H                       c    (8\
(______________________________________________________________)
