      000000       000000       0000000         
 000000MMMM000000000MMMM000000000MMMMM0         
 0                                    0         
 0H                                   00        
000                                    0        
0 0                                    0        
0K0                                    0        
0C00000000000WWWWWW0000000WWWWWW000000 00       
0C           RRRRR         RRRRR        0       
0                                       0       
0                             AA        0       
0             AA                        0       
0                                       0       
0                        0000RRRRRRRRRRR0000000 
0   RRRRRRRR00000RRRRRRRR0                    0 
7\                                            0 
7*\                                           0 
79*\                                          0 
799*\         o                               0 
7999*\                               D        0 
79999*\                    /555555555555WWWWW00 
799999*\                  /$99999999999999998   
7999999*\                /$999999999999999998   
79999999*\              /$9999999999999999998   
799999999*\     x      /$99999999999999999998   
7999999999*\          /$999999999999999999998   
79999999999*\        /$9999999999999999999998   
799999999999*55555555$99999999999999999999998   
799999999999999999999999999999999999999999998   
799999999999999999999999999999999999999999998   
799999999999999999999999999999999999999999998   
(6666666666666666666666666666666666666666666)   
                                                
                                                
                                                
                                                
                                                
                                                
                                                
                                                
                                                
                                                
                                                
                                                
                                                
                                                
                                                
                                                
