                        
                        
  /##################\  
  #                  #  
  #                  #  
  #                  #  
  #                  #  
  #                  #  
  #                  #  
  #           S      #  
  #                  #  
  #                  #  
  # H              D #  
  (##################)  
                        
                        
