################
#              #
#              #
#              #
#         /#   #
#CCC     /)    #
#       /) K   #
#      /########
#              #
#              #
#  CCC  c      #
#              #
#\             #
(#\            #
 (#\      H  D #
  (#############
