                                                                
                                                                
                                                                
                                                                
                                                                
                                                                
                                                                
                                                                
                                                                
                                                                
                                                                
       /555555555555550000000000000000000000000000000           
       7999999999999#)                              0           
       799999999999#)                               0           
       79999999999#)                                0           
       7999999999#)   R /555555\    x    /5555\     0           
       799999999#)     /$#6666~*\       /$9999*\    0           
       79999999#)     /$#)b  b(~*\      7#666~9*\   0           
       7999999#) R   /$#)      (~*\     78MMM(~9*\ D0           
       799999#)     /$#)        (~*\    78    (~90000           
       79999#)     /$#)          (~*\   78     (~9998           
       7999#)     /$#)            (~*\ /$8      (~998           
       799#)     /$#)              (~*5$#)       7998           
       79#)     /$#)                (~9#) /5\    7998           
       (#)     /$#)                  (6) /$98    7998           
        0     Q7#)        0   0         /$#6)    7998           
        0      78L                      7#)      7998           
        0P     78                       78       7998           
        0P     78L                     J78       7998           
        0      7*\                     /$8       R998           
        0     Q79*\         H         /$98       R998           
        7\     (~9*\      0   0      /$9#)       R998           
        7*\     (~9*\               /$9#)        R998           
        79*\     (~9*\             /$9#)        /9998           
        799*\    J0~9*\           /$9#)    x   /$9998           
        7999*\     (~9*\         /$9#)        /$99998           
        79999*\B    (~9*\       /$9#)        /$999998           
        799999*0     (~9*\     /$9#)    x   /$9999998           
        7999999*\     (~9*\   /$9#)        /$99999998           
        79999999*\     (~9*RRR$9#)        /$999999998           
        799999999*\     (6)   (6)    x   /$9999999998           
        7999999999*\                    /$99999999998           
        79999999999*\                  /$999999999998           
        799999999999*\                /$9999999999998           
        7999999999999*\              /$99999999999998           
        79999999999999*\      /555555$999999999999998           
        7999999999999998      79999999999999999999998           
        7999999999999998      79999999999999999999998           
        7999999999999998      79999999999999999999998           
        7999999999999998RR  RR79999999999999999999998           
        7999999999999998      79999999999999999999998           
        7999999999999998      79999999999999999999998           
        7999999999999998CCCCCC79999999999999999999998           
        7999999999999998CCCCCC79999999999999999999998           
        7999999999999998      79999999999999999999998           
        7999999999999998      79999999999999999999998           
        7999999999999998   o  79999999999999999999998           
        7999999999999998      79999999999999999999998           
        799999999999999*\K   /$9999999999999999999998           
        7999999999999999*5555$99999999999999999999998           
        799999999999999999999999999999999999999999998           
        799999999999999999999999999999999999999999998           
        (~99999999999999999999999999999999999999999#)           
         (66666666666666666666666666666666666666666)            
