 1111111111111111111111 
3999999999999#666666~994
39#6666~9999#)      (~94
3#)    (~99#)     C  794
38      (66)     CKC 794
38  D     0       C  794
38  0                794
38       0 0         794
38                   794
38       0 0         794
38                   794
38       0 0         794
38                  /$94
38       0 0       /$994
38        H       /$9994
38        0      /$99994
38       /5555555$999994
38      /$99999999999994
38     /$999999999999994
3*\WWW/$9999999999999994
39*555$99999999999999994
399999999999999999999994
399999999999999999999994
 2222222222222222222222 
