 1111111111111111111111 
399999999999996666669994
3996666999999)      (994
39)    (9999)     C  794
38      (66)     CKC 794
38  D     0       C  794
38  0                794
38       0 0         794
38                   794
38       0 0         794
38                   794
38       0 0         794
38                  /994
38       0 0       /9994
38        H       /99994
38        0      /999994
38       /55555559999994
38      /999999999999994
38     /9999999999999994
39\WWW/99999999999999994
399555999999999999999994
399999999999999999999994
399999999999999999999994
 2222222222222222222222 
