                                                                
                                                                
                                                                
                                                                
                                                                
00000                                /\                         
0   000000000000000000000000000000000$*\                        
0   C  MM                C          (~9*\                       
0   0                    C   C       (~9*\                      
0   0    A000000000000000C     x      (~9*\                     
0   0    A099999999999990  x           (~9*\                    
0   000000099999999999990    CA    x    (~9*\                   
0   099999999999999999990C     CCC       (~9*\                  
0   066666666666666666660    x   C        (~#00000000000000     
0                   MMMM0 CC     C   x     ()       MMMMMM0     
0                       0  C      AC       CC           CK0     
0                       0     x    C       CC           CC0     
0                       0       C   CC     /\             0     
0CCCC05555555555\       0  x    C x  C    /$*\            00    
0    0666666666~*\      0    CC      C   /$9#)            A0    
0   00MMMMMMMMM(~*\     0          CCC  /$9#)     o       A0    
0   0           (~*\    0   x     CC    (~9*\         o    0    
0   0            (~*\   0     CCCCC      (~9*\             0    
0   0             (~*\  C    CC           (~9*\            0    
0   0              (~*\ C                  (~9*\           0    
0   0               (~*\C            Q5\CCCC(~9*\    o     00   
0   0  AA            (~*\            Q98CCCCC(~9*\         Q0   
0 000      R  RRRR    (~*\           Q98      (~9*\        Q0   
0 00       R  AA R     (~*\          Q98       (~9*\       Q0   
0  0             R      (~*\   00000006)        (~9*\      Q0   
0  0             R       (6)CCC0                 (~9*\ CC  00   
0  0             R           C 0                  (~9*\CC000    
0AA000              CC      CC 0        R    R     (~9)  0      
0    0               CCCC  CC  0             R      ()   0      
0    0                 CC CC   0     R                   0      
0    0               CCC C     0      R                  0      
0    RRRR00000000  CCC         0           R A           00     
0               0  CCCCCC      0            A             0     
00              0  C   CC      0           A       R      0     
70              0  C    CCCCC  0     R     R           R  0     
70000CCCC0000AA 0  CC      C   0                          0     
7999*\CC/$990   0   C     CC   0                          000   
7999#)  (~990   0   C          0              R            Q0   
7999*\  /$990   0              0       R                   Q0   
7999#)  (~990CCC05\            0                      R    Q0   
7999*\  /$90L   (~8CC00000000000                           Q0   
7999#)  (~90    /$8            CC                          Q0   
7999*\  /$90    (~8            CC                          Q0   
7999#)  (~90    /$8       A0000000000000000000000000       Q0   
7999*\  /$90A   (~8       00P                     Q0       Q0   
7999#)  (~90    /$8       0               AA      Q0        0   
7999*\  /$90    (~8       0                       Q0        0   
7999#)  (~90    /$8       0                       Q0        0   
7999*\  /$90B   (~8CC000000                        C  AA    0   
7999#)  (~900CCC/$8  0                             C        0   
7999*\  /$990   (~8  0D      00000000              C       00   
7999#)  (~990   /$8  000000000  b   0              C       0    
7999*\  /$990   (6)  C  b           00000          C       0    
7999#)  (~990        C              C  b000000000000       0    
79998    7990        C              C           b  C       0    
7999*\H /$990    B   C     B000000000              C       0    
79999*55$99900000000000000000       0B       B     C   WWWW0    
7999999999990                       000000000000000000000000    
(666666666660                                                   
