     00000000000000000000000000000000000000000000000000000000000
     0                                                         0
     0                                                         0
     0   D                                                     0
 /55555555555555555555555555555555555555555555555555555555550  0
 7#6666666666666666666666666666666666666666666666666666666660  0
 78                MMMMMMMMMMMMMMMMMMMMMMMMMMMMMMMMMMMMMMMM00  0
 7*\                                                           0
 79*\   H                                                      0
 799*\  00   00                                             0000
 7999*\                                                     0   
 79999*\          0AAA                                      0   
 799999*\    x    0000       0                              0   
 7999999*\                0000          AAA                 R   
 79999999*\                                                 RR  
 799999999*\                                                 R  
 7999999999*\    x                  0000000000               R  
 79999999999*\                                          0    R  
 799999999999*\                                        00    R  
 7999999999999*\            o                           00   R  
 79999999999999*\                 o     o    o          0    R  
 799999999999999*\    x                          o           R  
 7999999999999999*\                                          R  
 79999999999999999*\                                         R  
 799999999999999999*\                                        R  
 7999999999999999999*\                                       R  
 79999999999999999999*\    x                                /5\ 
 799999999999999999999*\                                   /$98 
 7999999999999999999999*\                                 /$998 
 79999999999999999999999*\                               /$9998 
 799999999999999999999999*\                             /$99998 
 7999999999999999999999999*\                           /$999998 
 79999999999999999999999999*\                         /$9999998 
 799999999999999999999999999*\                       /$99999998 
 7999999999999999999999999999*\                     /$999999998 
 7999999999999999999999999999#)00A0 0A0 0A0 0CCCCCC/$9999999998 
 799999999999999999999999999#) 0                   (~9999999998 
 R66666666666666666666666666)  0                    (666666666) 
 R                             0                         Q0     
 R                             0                         Q0     
 R                             00          /5\           Q0     
 R                              00000RRRRRR79*\          Q0     
 R        CCCCC                            (~9*\         Q0     
 R        CCKCC                             (~9*\        Q0     
 R        CCCCC                              (~9*\       Q0     
 R                                            (~9*\      R      
 R                                             (~98      R      
 R                            RRRRRR\           (~8      R      
 R                                (~*\           ()      R      
 R                                 (~*\                 /5\     
 R                                  (~*\               /$98     
 R                                   (~*\             /$998     
 R                                    (~*\           /$9998     
 RCCCCCCC            CCCCCC            (~*\         /$99998     
 R                                      (~*\       /$999998     
 R                                       (~*\     /$9999998     
 RWWWWWWWWWWWWWWWWWWWWWWWWWWWWWW       AAA(~0P   /$99999998     
 R5555555555555555555555555555555555555000000P  /$999999998     
 79999999999999999999999999999999999999999990P /$9999999998     
 7999999999999999999999999999999999999999999005$99999999998     
 7999999999999999999999999999999999999999999999999999999998     
 7999999999999999999999999999999999999999999999999999999998     
 7999999999999999999999999999999999999999999999999999999998     
 (66666666666666666666666666666666666666666666666666666666)     
